OPQOPQOPQWWWWW
GNNNNNNNDUTRUR
DEFFFFGDDRTTRR
GHIIIIIIGRRTRR
KKLLLLLLKURTUR
NDNDNNDNNSSSSS
